.S###################
..#.......#.........#
#.#.###.###.###.###.#
#...#.....#.#.....#.#
#.#.#######.#.#.###.#
#.#...#.....#.#.#...#
#.#############.###.#
#...#.......#.....#.#
###.#.#########.###.#
#.....#...........#.#
#.#############.###.#
#...#.....#...#.#...#
#.#####.#.###.###.#.#
#.#.#.#.#...#...#.#.#
#.#.#.#.#.###.###.###
#.#.....#.....#.....#
#.#.#######.#######.#
#...#.#.....#.#...#.#
#.###.#####.#.#.###.#
#.......#...........#
###################E#
