S....#..#...
##.#.#.#...#
....#.#.#...
.#.....#.#.#
.#.#......##
...#...#..#.
.#...#.#...#
.#.#........
.#.#.#.###..
....#.#.#E##
........####